NO ./textures/wall_ea.xpm
SO ./textures/wall_ea.xpm
EA ./textures/wall_ea.xpm
WE ./textures/wall_ea.xpm
C 255,255,255
F 0,0,255


111111111
100000001
100000001
100N00001
111111111
