NO afaf   
SO fafaf
EA fafaf
WE fafaf
C 255,255,255
F 0,0,255


11111111
10111111
111110101
100N1111
11111111