NO afaf
SO fafaf
EA fafaf
WE fafaf
C 255,255,255
F 0,0,255


111111111
101111111
111110101
100N10111
111111111
